################################################
#----------------------------------------------#
#----------------------------------------------#
#----------------------------------------------#
#-----------3----------------------------------#
#-----------24--------@------------------------#
#                                              #
#                                              #
#                                              #
#                                              #
#                                              #
#                                              #
#                                              #
#                                              #
################################################