##################################################
#333333333333333333333333333333333333333333333333#
#333333333333333333333333433333333333333333333333#
#33333333333333333@333333334333333333333333333333#
#3333333333333333333333333343333333333333@3333333#
#333333333333433333333@33333333333333443333333333#
#333333333333333333333333333333333333333333333333#
#333334343333333333333333333333334443333333333333#
#333333333333333333333333333333333333333333333333#
#                                                #
#                                                #
#                                                #
#                                                #
#                                                #
#                                                #
#                                                #
#                                                #
#                                                #
#                                                #
#                                                #
#                                                #
#                                                #
#                                                #
#                                                #
#                                                #
#                                                #
#                                                #
#                                                #
#                                                #
#                                                #
#                                                #
#                                                #
#                                                #
#                                                #
#                                                #
#                                                #
#                                                #
#                                                #
#                                                #
#                                                #
#                                                #
#                                                #
#                                                #
#                                                #
##################################################