##################################################
#222222222222222222222222222222222222222222222222#
#223322222222222222222223422222222222222222222222#
#222222222222222222222222224222222222222222222222#
#2222222222232222222222222242222222222222@2222222#
#222222222222422222222@22222222222222222222222222#
#222222222222222222222222222222222222222222222222#
#222224242222222222222222222222224442222222222222#
#222222222222222222222222222222222222222222222222#
#                                                #
#                                                #
#                                                #
#                                                #
#                                                #
#                                                #
#                                                #
#                                                #
#                                                #
#                                                #
#                                                #
#                                                #
#                                                #
#                                                #
#                                                #
#                                                #
#                                                #
#                                                #
#                                                #
#                                                #
#                                                #
#                                                #
#                                                #
#                                                #
#                                                #
#                                                #
#                                                #
#                                                #
#                                                #
#                                                #
#                                                #
#                                                #
#                                                #
#                                                #
#                                                #
##################################################